data,stato,codice_regione,denominazione_regione,lat,long,ricoverati_con_sintomi,terapia_intensiva,totale_ospedalizzati,isolamento_domiciliare,totale_positivi,variazione_totale_positivi,nuovi_positivi,dimessi_guariti,deceduti,totale_casi,tamponi,casi_testati,note_it,note_en
<<<<<<< HEAD
<<<<<<< HEAD
2020-05-02T17:00:00,ITA,13,Abruzzo,42.35122196,13.39843823,303,16,319,1560,1879,-32,16,758,327,2964,39916,29308,,
2020-05-02T17:00:00,ITA,17,Basilicata,40.63947052,15.80514834,48,4,52,139,191,-2,2,164,25,380,13722,13722,,
2020-05-02T17:00:00,ITA,04,P.A. Bolzano,46.49933453,11.35662422,113,10,123,580,703,-54,7,1553,279,2535,43804,20036,,
2020-05-02T17:00:00,ITA,18,Calabria,38.90597598,16.59440194,100,4,104,609,713,-14,0,311,88,1112,37928,35975,,
2020-05-02T17:00:00,ITA,15,Campania,40.83956555,14.25084984,470,27,497,2224,2721,-32,15,1376,362,4459,83592,45955,,
2020-05-02T17:00:00,ITA,08,Emilia-Romagna,44.49436681,11.3417208,2033,196,2229,7094,9323,-161,206,12913,3614,25850,192135,128005,,
2020-05-02T17:00:00,ITA,06,Friuli Venezia Giulia,45.6494354,13.76813649,131,5,136,973,1109,-6,18,1655,295,3059,73855,47259,,
2020-05-02T17:00:00,ITA,12,Lazio,41.89277044,12.48366722,1370,96,1466,2986,4452,6,84,1807,497,6756,147078,114761,,
2020-05-02T17:00:00,ITA,07,Liguria,44.41149315,8.9326992,647,68,715,2883,3598,80,186,3519,1195,8312,53202,34037,,
2020-05-02T17:00:00,ITA,03,Lombardia,45.46679409,9.190347404,6529,545,7074,29593,36667,194,533,26146,14189,77002,403702,243383,dc-IT-0016,dc-EN-0016
2020-05-02T17:00:00,ITA,11,Marche,43.61675973,13.5188753,399,46,445,2760,3205,-6,23,2177,916,6298,62834,41156,,
2020-05-02T17:00:00,ITA,14,Molise,41.55774754,14.65916051,9,1,10,172,182,-8,1,98,21,301,7075,6808,,
2020-05-02T17:00:00,ITA,01,Piemonte,45.0732745,7.680687483,2550,178,2728,12991,15719,157,495,8334,3126,27179,168479,118814,,
2020-05-02T17:00:00,ITA,16,Puglia,41.12559576,16.86736689,416,39,455,2499,2954,7,34,757,422,4133,65370,63782,,
2020-05-02T17:00:00,ITA,20,Sardegna,39.21531192,9.110616306,86,13,99,631,730,-14,2,466,119,1315,26990,24065,,
2020-05-02T17:00:00,ITA,19,Sicilia,38.11569725,13.3623567,396,30,426,1760,2186,15,19,787,240,3213,84352,77590,,
2020-05-02T17:00:00,ITA,09,Toscana,43.76923077,11.25588885,519,118,637,4728,5365,-8,80,3297,863,9525,148223,112437,,
2020-05-02T17:00:00,ITA,04,P.A. Trento,46.06893511,11.12123097,138,19,157,1125,1282,-11,49,2474,425,4181,39579,23380,,
2020-05-02T17:00:00,ITA,10,Umbria,43.10675841,12.38824698,60,13,73,123,196,-8,1,1130,68,1394,38072,26463,,
2020-05-02T17:00:00,ITA,02,Valle d'Aosta,45.73750286,7.320149366,70,3,73,25,98,6,3,901,137,1136,7951,5931,,
2020-05-02T17:00:00,ITA,05,Veneto,45.43490485,12.33845213,970,108,1078,6353,7431,-348,126,9291,1502,18224,370978,216997,,
=======
2020-05-06T17:00:00,ITA,13,Abruzzo,42.35122196,13.39843823,285,11,296,1495,1791,-18,22,915,341,3047,43803,31502,,
2020-05-06T17:00:00,ITA,17,Basilicata,40.63947052,15.80514834,47,3,50,122,172,-5,3,202,25,399,16103,15619,,
2020-05-06T17:00:00,ITA,04,P.A. Bolzano,46.49933453,11.35662422,99,11,110,469,579,-33,1,1678,286,2543,46228,20872,,
2020-05-06T17:00:00,ITA,18,Calabria,38.90597598,16.59440194,87,3,90,554,644,-6,3,389,89,1122,41828,39780,,
2020-05-06T17:00:00,ITA,15,Campania,40.83956555,14.25084984,433,25,458,1882,2340,-190,14,1816,376,4532,96548,49478,,
2020-05-06T17:00:00,ITA,08,Emilia-Romagna,44.49436681,11.3417208,1816,176,1992,6399,8391,-290,104,14251,3737,26379,211652,138871,,
2020-05-06T17:00:00,ITA,06,Friuli Venezia Giulia,45.6494354,13.76813649,115,3,118,844,962,-22,9,1826,306,3094,79429,50698,,
2020-05-06T17:00:00,ITA,12,Lazio,41.89277044,12.48366722,1351,91,1442,2991,4433,63,81,2024,538,6995,160894,125897,,
2020-05-06T17:00:00,ITA,07,Liguria,44.41149315,8.9326992,548,59,607,2699,3306,-121,76,4002,1243,8551,59693,37177,,
2020-05-06T17:00:00,ITA,03,Lombardia,45.46679409,9.190347404,6079,480,6559,25194,31753,-5339,764,33005,14611,79369,439806,262964,dc-IT-0020,dc-EN-0020
2020-05-06T17:00:00,ITA,11,Marche,43.61675973,13.5188753,353,42,395,2841,3236,17,29,2242,943,6421,69037,45026,,
2020-05-06T17:00:00,ITA,14,Molise,41.55774754,14.65916051,9,0,9,170,179,2,3,103,22,304,7896,7604,,
2020-05-06T17:00:00,ITA,01,Piemonte,45.0732745,7.680687483,2147,150,2297,12561,14858,-465,165,9834,3247,27939,188057,131269,,
2020-05-06T17:00:00,ITA,16,Puglia,41.12559576,16.86736689,365,36,401,2502,2903,-36,26,855,438,4196,70944,68760,,
2020-05-06T17:00:00,ITA,20,Sardegna,39.21531192,9.110616306,91,11,102,521,623,-19,1,577,119,1319,29966,26598,,
2020-05-06T17:00:00,ITA,19,Sicilia,38.11569725,13.3623567,359,25,384,1817,2201,-1,14,830,250,3281,92999,83908,,
2020-05-06T17:00:00,ITA,09,Toscana,43.76923077,11.25588885,462,92,554,4534,5088,-102,26,3670,899,9657,161553,121066,,
2020-05-06T17:00:00,ITA,04,P.A. Trento,46.06893511,11.12123097,116,13,129,853,982,-59,19,2861,437,4280,44719,26161,,
2020-05-06T17:00:00,ITA,10,Umbria,43.10675841,12.38824698,55,9,64,107,171,-5,4,1163,70,1404,41328,28712,,
2020-05-06T17:00:00,ITA,02,Valle d'Aosta,45.73750286,7.320149366,50,3,53,74,127,17,3,880,139,1146,8640,6461,,
2020-05-06T17:00:00,ITA,05,Veneto,45.43490485,12.33845213,902,90,992,5797,6789,-327,77,10122,1568,18479,399806,231469,,
>>>>>>> 44dde7ca11b83b24840315d553018c817698452f
=======
2020-05-03T17:00:00,ITA,13,Abruzzo,42.35122196,13.39843823,300,16,316,1552,1868,-11,32,798,330,2996,40699,29788,,
2020-05-03T17:00:00,ITA,17,Basilicata,40.63947052,15.80514834,48,3,51,143,194,3,6,167,25,386,14210,14210,,
2020-05-03T17:00:00,ITA,04,P.A. Bolzano,46.49933453,11.35662422,109,11,120,545,665,-38,1,1590,281,2536,44240,20166,,
2020-05-03T17:00:00,ITA,18,Calabria,38.90597598,16.59440194,95,4,99,603,702,-11,2,324,88,1114,38835,36874,,
2020-05-03T17:00:00,ITA,15,Campania,40.83956555,14.25084984,455,30,485,2241,2726,5,25,1394,364,4484,86498,47027,,
2020-05-03T17:00:00,ITA,08,Emilia-Romagna,44.49436681,11.3417208,1997,197,2194,6851,9045,-278,166,13329,3642,26016,197075,131047,,
2020-05-03T17:00:00,ITA,06,Friuli Venezia Giulia,45.6494354,13.76813649,131,6,137,950,1087,-22,13,1688,297,3072,74990,48041,,
2020-05-03T17:00:00,ITA,12,Lazio,41.89277044,12.48366722,1346,95,1441,2944,4385,-67,53,1916,508,6809,150912,117796,,
2020-05-03T17:00:00,ITA,07,Liguria,44.41149315,8.9326992,627,68,695,2856,3551,-47,47,3599,1209,8359,54492,34613,,
2020-05-03T17:00:00,ITA,03,Lombardia,45.46679409,9.190347404,6609,532,7141,29785,36926,259,526,26371,14231,77528,410857,247176,,
2020-05-03T17:00:00,ITA,11,Marche,43.61675973,13.5188753,400,43,443,2755,3198,-7,21,2194,927,6319,64412,42281,,
2020-05-03T17:00:00,ITA,14,Molise,41.55774754,14.65916051,8,1,9,172,181,-1,0,98,22,301,7075,6808,,
2020-05-03T17:00:00,ITA,01,Piemonte,45.0732745,7.680687483,2496,169,2665,12973,15638,-81,251,8640,3152,27430,172208,121176,,
2020-05-03T17:00:00,ITA,16,Puglia,41.12559576,16.86736689,410,40,450,2505,2955,1,11,765,424,4144,66443,64781,,
2020-05-03T17:00:00,ITA,20,Sardegna,39.21531192,9.110616306,92,10,102,587,689,-41,4,511,119,1319,27737,24662,,
2020-05-03T17:00:00,ITA,19,Sicilia,38.11569725,13.3623567,383,29,412,1791,2203,17,27,795,242,3240,85955,78409,,
2020-05-03T17:00:00,ITA,09,Toscana,43.76923077,11.25588885,513,112,625,4703,5328,-37,38,3363,872,9563,150914,114354,,
2020-05-03T17:00:00,ITA,04,P.A. Trento,46.06893511,11.12123097,136,17,153,1094,1247,-35,66,2571,429,4247,41095,24085,,
2020-05-03T17:00:00,ITA,10,Umbria,43.10675841,12.38824698,58,13,71,112,183,-13,0,1143,68,1394,38823,26973,,
2020-05-03T17:00:00,ITA,02,Valle d'Aosta,45.73750286,7.320149366,74,2,76,33,109,11,6,895,138,1142,8100,6046,,
2020-05-03T17:00:00,ITA,05,Veneto,45.43490485,12.33845213,955,103,1058,6241,7299,-132,94,9503,1516,18318,378202,220598,,
>>>>>>> master
